1111111111
1111111111
1111100000
1111100000
1111100000
1111111111
1111111111
0000011111
0000011111